..................+..............................................................................................
..................|..............................................................................................
..................|..............................................................................................
..................|..............................................................................................
..................|..............................................................................................
..................|..................................#...........................................................
..................|..................................#.....................#...........#...............#.........
..................|..................................#.....................#...........#...............#.........
..................|..................................#######################...........#...............#.........
..........|||||||||||||||||............................................................#....#...#......#.........
..........|#~~~~~~~~~~~~~#|............................................................#....#...#......#.........
..........|#~~~~~~~~~~~~~#|............................................................#....#...#......#.........
......#...|#~~~~~~~~~~~~~#|............................................................#....#...#......#.........
.#....#...|#~~~~~~~~~~~~~#|............................................................#....#...#......#.........
.#....#...|#~~~~~~~~~~~~~#|............................................................#....#####......#.........
.#....#...|#~~~~~~~~~~~~~#|......................#..#..................................#...............#.........
.#....#...|#~~~~~~~~~~~~~#|......................#..#..................................#...............#.........
.#....#...|#~~~~~~~~~~~~~#|......................#..#..................................#...............#.........
.#....#...|#~~~~~~~~~~~~~#|......................#..#..........#.......................#...............#.........
.#....#...|#~~~~~~~~~~~~~#|......................#..#..........#...................#...#...............#.........
.#....#...|#~~~~~~~~~~~~~#|......................#..#..........#...................#...#...............#.........
.#....#...|###############|......................#..#..........#...................#...#################.........
.#....#...|...............|......................#..#..........#...................#.............................
.#....#...|...............|......................#..#..........#####################.............................
.#....#...|...............|......................#..#............................................................
.#....#...|...............|......................####............................................................
.#....#...|...............|......................................................................................
.#....#...|...............|......................................................................................
.#....#...|...............|...................................#..................................................
.#....#...|......#|||||||||||||||||.........................#.#..................................................
.#....#...|......#~~~~~~~~~~~~~~~#|.........................#.#..................................................
.#....#...|......#~~~~~~~~~~~~~~~#|.........................#.#..................................................
.######...|......#~~~~~~~~~~~~~~~#|.........................#.#..................................................
..........|......#~~~~~~~~~~~~~~~#|.........................#.#..................................................
..........|......#~~~~~~~~~~~~~~~#|.........................#.#..................................................
..........|......#~~~~~~~~~~~~~~~#|.........................#.#..................................................
..........|......#~~~~~~~~~~~~~~~#|.........................#.#..................................................
..........|......#~~~~~~~~~~~~~~~#|.........................#.#..............................#.............#.....
..........|......#~~~~~~~~~~~~~~~#|.........................#.#..............................#.............#.....
..........|......#~~~~~~~~~~~~~~~#|.........................#.#..............................#.............#.....
..........|......#~~~~~~~~~~~~~~~#|.........................#.#..............................#.............#.....
..........|......#################|.........................#.#..............................#.............#.....
..........|.......................|.........................#.#..............................#.............#.....
..........|.......................|.........................#.#..............................#.............#.....
..........|.......................|.........................#.#..............................#.............#.....
..........|.......................|.........................#.#............#........#........#.............#.....
..........|.......................|.........................#.#............#........#........#.............#.....
..........|.......................|.........................#.#............#........#........#.............#.....
...#......|.......................|.........................#.#............#........#........#.............#.....
...#......|.......................|.............#...........#.#............#........#........#.............#.....
...#......|.......................|.............#...........#.#............#........#........#.............#.....
...#~~~~~~~~~~~~~~~~~~~~~~~~~~~~~~~~~~~~~~~~~~~~#...........#.#............#........#........#.............#.....
...#~~~~~~~~~~~~~~~~~~~~~~~~~~~~~~~~~~~####~~~~~#...........#.#............#........#........#.............#.....
...#~~~~~~~~~~~~~~~~~~~~~~~~~~~~~~~~~~~#..#~~~~~#...........#.#............#........#........#.............#.....
...#~~~~~~~~~~~~~~~~~~~~~~~~~~~~~~~~~~~#..#~~~~~#...........###............#........#........#.............#.....
...#~~~~~~~~~~~~~~~~~~~~~~~~~~~~~~~~~~~####~~~~~#..........................#........#........#.............#.....
...#~~~~~~~~~~~~~~~~~~~~~~~~~~~~~~~~~~~~~~~~~~~~#..........................#........#........#.............#.....
...#~~~~~~~~~~~~~~~~~~~~~~~~~~~~~~~~~~~~~~~~~~~~#..........................#........#........###############.....
...#~~~~~~~~~~~~~~~~~~~~~~~~~~~~~~~~~~~~~~~~~~~~#..........................#........#............................
...#~~~~~~~~~~~~~~~~~~~~~~~~~~~~~~~~~~~~~~~~~~~~#..........................#........#............................
...#~~~~~~~~~~~~~~~~~~~~~~~~~~~~~~~~~~~~~~~~~~~~#..........................#........#............................
...#~~~~~~~~~~~~~~~~~~~~~~~~~~~~~~~~~~~~~~~~~~~~#..........................#........#............................
...##############################################..........................#........#............................
...........................................................................#........#............................
